                              111
                            110001
11111111111111111111111111111111111111111
1E0000000000000C00000C0000000000010010011
 10100101001000001010010000000101010001001
 10100100101010100010010000000101000000101
1P0000000C00C0000000000000000000C110111001
1111100000111111111111111111111100000001000000
     1111111111111110000000000000111111111
     100000000000000011111111111111
      111111111111111
