1111111111111111111111111111111111111111
1E0000000000000C00000C0000M0000001001001
1101001010010000010100100000001010100011
1101001001M101010001001000M000101C000001
1P0000000C00C000000000000000000000000001
1111100000111111111011111111111100000001
1111111111111111111000000000000011111111
1111111000000000000000111111111111111111
1111111111111111111111111111111111111111
1111111111111111111111111111111111111111
