11111111111
1P101E101C1
11111111111
