111111111111111111111111111111111111111111
1E0000000000000C00000C00000000000100100111
110100101001000001010010000000101010001001
110100100101010100010010000000101000000101
1P0000000C00C0000000000000000000C110111001
111110000011111111101111111111110000000111
111111111111111111100000000000001111111111
111111100000000000000011111111111111111111
111111111111111111111111111111111111111111
111111111111111111111111111111111111111111
111111111111111111111111111111111111111111
111111111111111111111111111111111111111111
111111111111111111111111111111111111111111
