1111111111111111111111111111111111111111
1000000000000000000000000000000000000001
1010101100000110000111000011110000000001
100010000000011000011100001111000000P001
10000E0000000000000111000011110000000001
100000CCCCPCC0000000000C0011110000000001
10011111110000010000000C0000000000000001
10000000000000010000000C0000000000000001
10000000000000010000000C0000000000000001
10000000000000010000000C000000000C000001
10000000000000P0000000000000000000000001
1PCE000000000000000000000000000000000001
1111111111111111111111111111111111111111
